NO ./makefile
SO ./makefile
WE ./makefile
EA ./makefile
F 126,132,107
C 255,255,255

111111111111111111111111111
100000000000000000000000001
101111111100011111111111111111
1000000000000000000000000011N1
111111111111111111111111111111