NO ./TEKWALL1.xpm
SO ./TEKWALL2.xpm
WE ./TEKWALL4.xpm
EA ./TEKWALL5.xpm
F 0,15,7
C 208,221,215

        1111111111111111111111111
        1000000000110000000000001
        1011000001110000000000001
        1001000000000000000000001
111111111011000001110000000000001
100000000011000001110111111111111
1111011111111101110N000000001
11110111111111011101010010001
11000000111101011100000010001
1000000001 100001100000010001
10000000001000001101010010001
1100000111010101111101111000111
11110111 1110101 101111010001
11111111 1111111 111111111111